QQQQQQQQQ QQQQQQQQQQQQQQQQQQQQQQ
Q                              Q
Q                              Q
Q                              Q
Q                              Q
Q                              Q
Q                              Q
Q                              Q
Q  R   ~                  @    Q
Q                 QQQQQQQQQQQ  Q
Q                              Q
Q                              Q
Q                              Q
Q                              Q
Q      ~       @               Q
QQQQQQ QQQQQQQ QQQQQQ QQQQQ QQQQ
