QQQQQQQQQQQQQQQQQQQQQQQQQQQQQQQQ
Q                              Q
Q                              Q
Q                              Q
Q                              Q
Q                              Q
Q R                        @   Q
Q     ######################   Q
Q                              Q
Q                              Q
Q                              Q
Q                              Q
Q                              Q
Q                              Q
Q                              Q
QQQQQQQQQQQQQQQQQQQQQQQQQQQQQQQQ
