QQQQQQQQQQQQQQQQQQQQQQQQQQQQQQQQ
Q                              Q
Q                              Q
Q                              Q
Q                              Q
Q                              Q
Q R     T  %  '''''''' @       Q
Q     Oo-QqpPsSHOo-QqpPsS      Q
Q                              Q
Q                              Q
Q                              Q
Q        b   b    ?            Q
Q         b b                  Q
Q          b                   Q
Q                              Q
QQQQQQQQQQQQQQQQQQQQQQQQQQQQQQQQ
