OOOOOOOOOOOOOOOOOOOOOOOOOOOOOOOO
O                              O
O                              O
O                 ^            O
O     %       !                O
O                              O
O     R D    TTT        @      O
O     OOOOOOOOOOOOOOOOOOO      O
O                              O
O                              O
O                              O
O        b   b#   ?            O
O         b b#                 O
O          b#                  O
O                              O
OOOOOOOOOOOOOOOOOOOOOOOOOOOOOOOO
